Call home!	Киле шӑнкӑравла.
I love you.	Эпӗ сана саватӑп.
Anyone hurt?	Аманнисем пур и?
Be tolerant.	Толерантлӑ пул.
I hate dogs.	Йытӑсене кураймастӑп.
Are you sure?	Чӑнах и?
Tom's guilty.	Том айӑплӑ.
I have a home.	Манӑн пӳрт пур.
Speak quietly.	Шӑпӑрт калаҫ.
That's a fish.	Ку пулӑ.
Are you hungry?	Эсӗ выҫӑ и?
Happy New Year!	Телейлӗ Ҫӗнӗ Ҫул!
He looks happy.	Вӑл телейлӗ курӑнать.
I need a towel.	Мана алшӑлли кирлӗ.
It's not funny.	Кулӑш мар ку!
My tooth hurts.	Шӑлӑм ыратать.
What do you do?	Мӗн тӑватӑн?
What do you do?	Мӗн ӗҫлетӗн?
I bought a book.	Эпӗ кӗнеке илтӗм.
I was skeptical.	Эпӗ шанӑҫсӑрлӑччӗ.
It works for me.	Ку мана валли ӗҫлеть.
It's not a joke.	Ку шӳт мар!
There was music.	Ку музыкӑччӗ.
We'll need that.	Ҫак пире кирлӗ пулӗ.
I didn't like it.	Ку мана килӗшменччӗ.
I like chocolate.	Шоколад юрататӑп.
I live near here.	Кунтан ҫывӑхах пурӑнатӑп.
I play in a band.	Ушкӑнра вылятӑп.
I want us to win.	Эпир ҫӗнтерсе илнине кӑмӑллатӑп.
Let's have a try.	Айта ҫӑрӑлса пӑхар!
Lower your voice.	Сассуна пӗчӗклет.
No one will know.	Никам та пӗлместь.
She is beautiful.	Вӑл чипер.
Tom is your boss.	Том сирӗн босс.
Are you a student?	Эсӗ вӗренетӗн и?
I went for a swim.	Эпӗ ишме кайнӑ.
I went for a swim.	Эпӗ шыва кӗме кайнӑ.
I work at the zoo.	Зоопаркра ӗҫлетӗп.
It was a bad idea.	Вӑл япӑх шухӑшччӗ.
Read it once more.	Вула куна тата тепӗр хут.
They went fishing.	Вӗсем пулла кайрӗҫ.
We don't have tea.	Чӗй ҫук.
Where's my father?	Кӑҫта манӑн атте?
Do I have to study?	Вӗренмелле ши?
I told him to come.	Уна кил тесе каларӑм.
The sun is shining.	Хӗвел ҫутатать.
Tom is at his desk.	Том сӗтел умӗнче.
Tom isn't drinking.	Том ӗҫместь.
Tom loves his wife.	Том арӑма юратать.
Why are you crying?	Ма эсир макӑратӑр?
You're my girl now.	Эсӗ халь манӑн хӗр.
Go jump in the lake.	Кӳлӗ кайса сик.
I am reading a book.	Кӗнеке вулатӑп.
I forgot to ask him.	Унран ыйтма манса кайрӑм.
I study mathematics.	Эпӗ математика вӗренетӗп.
That's why I'm here.	Ҫавӑнпа кунта эпӗ.
We know how to swim.	Эпир мӗнле ишмеллине пӗлетпӗр.
Why don't you start?	Мӗншӗн пуҫламастӑн.
Did you do your work?	Хӑвӑн ӗҫне турӑн и?
I know what happened.	Мӗн пулнине пӗлетӗп.
They walked together.	Вӗсем пӗрле ҫӳреттчӗҫ.
Does she like oranges?	Вӑл апельсин юратать и?
I never liked biology.	Биологи нихӑҫан та юратман.
I want to be like Tom.	Эпӗ Том пек пуласшӑн.
I want to be like Tom.	Манӑн Том пек пулассӑм килет.
I'll find another job.	Тата тепӗр ӗҫ шыраса тупатӑп.
Tom is big and strong.	Том пысӑк та хӑватлӑ.
Tom is big and strong.	Том пыӑк та вӑйлӑ.
Why did you come here?	Мӗн тума кунта килтӗн?
Did you see him go out?	Вӑл тула тухса кайнине куртӑн и?
I asked what was wrong.	Эпӗ мӗн тӗрӗс мар тесе ыйтрӑм.
I can handle it myself.	Ҫакна хамах татса параятӑп.
Mom, can I go swimming?	Анне, шыва кӗмӗ юрать и?
People are complicated.	Ҫынсем вӗсем кӑткӑс.
What made you think so?	Сире мӗн кумпек шухӑшлатталать?
You did a splendid job.	Чаплӑ ӗҫ турӑн.
You did a splendid job.	Питӗ аван ӗҫ турӑн.
She speaks good English.	Унӑн акӑлчанла калаҫӑвӗ лайӑх.
She visited the teacher.	Вӑл вӗрентӳҫӗ патне кайса килчӗ.
Tell me about this girl.	Ҫак хӗр пирки каласа парсам.
They got onto the plane.	Вӗҫмеке хӑпарчӗҫ.
Tom is a grumpy old man.	Том хаяр ҫын.
What's your nationality?	Наципе кам эсир?
He looks like he's drunk.	Вӑл ӗҫнӗ пек курӑнать.
I can't live without Tom.	Томсӑр пурӑнаймастӑп.
I learned a lot from him.	Унран нуммай мӗн вӗрентӗм.
Please take note of that.	Тархасшӑн, ҫакна ҫырса хурӑр.
Tom is no longer a child.	Том ачаран ҫӳллех мар.
We are worried about you.	Эпир саншӑн куллянатпӑр.
What was Tom's last name?	Том хушамачӗ мӗнлеччӗ?
What was Tom's last name?	Томӑн мӗнле хушаматччӗ?
Call me whenever you want.	Шӑнкӑравлас килсессӗн шӑнкӑравла.
Did you see anybody there?	Кама та пулин унта куртӑн и?
Everyone should know this.	Кашни ҫынӑн ҫакна пӗлмелле.
I won't forget any of you.	Сире никама та манмастӑп.
That's the absolute truth.	Ку чӑн тӗрӗс!
We'll meet in the theater.	Эпир театӑрта тӗл пулӑпӑр.
Why have you abandoned me?	Мӗншӗн эсӗ мана пӑрахса хӑвартӑн?
You should write a letter.	Санӑн ҫыру ҫырмалла.
You should write a letter.	Сирӗн ҫыру ҫырмалла.
You should write a letter.	Санӑн ҫыру ҫыраспӑть.
You should write a letter.	Сирӗн ҫыру ҫыраспӑть.
A minute has sixty seconds.	Пӗр минутра утмӑл ҫеккунт.
How much money do you want?	Мӗн чухлӗ укҫа сире кирлӗ?
I can't find the newspaper.	Хаҫат тупаймастӑп.
This always makes me laugh.	Ҫак япала мана яланах култарать.
You look very nice tonight.	Ҫак каҫ эсӗ аван курӑнатӑн.
You're not listening to me.	Эсӗ мана илтместӗн.
He said that he didn't know.	Вӑл хӑй пӗлменни пирки тесе каларӗ.
I'm not very good at French.	Францире мана пит лайӑхах мар.
Do you think I look like Tom?	Санӑн шухӑшупа эпӗ Том пек?
Don't forget your toothbrush.	Хӑвӑн шӑл щёткуна манса ан кай.
Everybody at school hates me.	Мана шкулта пурте кураймаҫҫӗ.
I go to school every morning.	Ирсерен шкула ҫӳретӗп.
She is not as patient as you.	Вӑл сан пекех чӑтӑмлӑ мар.
He asked his friends for help.	Вӑл юлташӗсенчен пулӑшу ыйтрӗ.
He asked his friends for help.	Вӑл юлташӑсене пулӑшма ыйтрӗ.
She is a good English speaker.	Вӑл лайӑх акӑлчанла калаҫаканӗ.
Tom doesn't have enough money.	Томӑн урӑх укҫа ҫук.
Tom lives and works in Boston.	Том Бостонра пурӑнать та ӗҫлеть.
Do you want something to drink?	Мӗн те пулин ӗҫетӗн и?
Every mistake made me stronger.	Кашни йӑнӑш мана вӑйлантарать.
He is suffering from toothache.	Шӑл ыратнипе аптӑрать.
He stopped to put on his shoes.	Пушмак тӑхӑнмашкӑн чарӑнчӗ.
I don't know what I should say.	Мӗн каламалла пӗлместӗп.
I just wanted to see you again.	Эпӗ сана курасшӑнччӗ кӑна.
I just wanted to see you again.	Эпӗ сана курасшӑнччӗ анчах.
I just wanted to see you again.	Эпӗ сире курасшӑнччӗ анчах.
I just wanted to see you again.	Эпӗ сире курасшӑнччӗ кӑна.
I'm a little worried about Tom.	Томшӑн кӑшт куллянтӑм.
Tom gave Mary some good advice.	Том Машука пӗр лайӑх сӗнӳ пачӗ.
Tom never came out of his coma.	Том комаран нихӑҫан та тухман.
I ate quesadillas for breakfast.	Ирхи апата касатилла ҫирӗм.
I want to go back to my cubicle.	Эпӗ хамӑн пӳлӗме таврӑнасшӑн.
I'll show you where we can hide.	Эпир кӑҫта пытанма пултарнине сана кӑтартатӑп.
She is good at speaking English.	Вӑл акӑлчанла лайӑх калаҫать.
Tom has no interest in politics.	Тома политикӑ кӑсӑклантармасть.
Why do you speak French so well?	Мӗншӗн эсӗ Французла ҫав терри лайӑх калаҫатӑн?
I don't have any pictures of you.	Манӑн санпа пӗр фото та ҫук.
I've just arrived at the station.	Эпӗ станцине ҫитрӗм анчах.
This information is confidential.	Ҫак пӗлӳ конфитенциаллӑ.
This information is confidential.	Ҫак информаци конфиденциаллӑ.
Tom knows what I'm talking about.	Эп каланине Том пӗлет.
You shouldn't lend Tom any money.	Сан Тома кивҫен укҫа памалла мар.
I shouldn't have touched anything.	Пӗр япалана та тӗкӗнмелле марччӗ ман.
Onions can be used in many dishes.	Сухан нумай апатра усӑ кураҫҫӗ.
She likes the design on the plate.	Ӑна савӑт капӑрлӑхе килӗшрӗ.
This is obviously a waste of time.	Ку, чӑннипе, вӑхӑт ҫухатни анчах.
This is obviously a waste of time.	Ку, чӑннипе, вӑхӑт ҫухатни кӑна.
I don't think she can speak French.	Вӑл французла калаҫать тесе шутламастӑп.
I love you and I want to marry you.	Эпӗ сана юрататӑп та сана кача тухасшӑн.
I love you and I want to marry you.	Эпӗ сана юрататӑп та манпа авлантарасшӑн.
I'll accompany you to the hospital.	Сыватӑша сана леҫсе яратӑп.
Sorry for calling you at this hour.	Ҫак вӑхӑтра сире шӑнкӑравланӑшӑн каҫарӑр.
We can do this if we work together.	Эпир пӗрле ӗҫлесен ҫак ӗҫе тӑваятпӑр.
You don't have to go to work today.	Санӑн паян ӗҫе каймалла мар.
I don't have anything to say to Tom.	Тома каламалли сӑмах ҫук.
He has good reason to get very angry.	Хытӑ ҫилленмешкӗн унӑн лайӑх сӑлтав пур.
I know him by name, but not by sight.	Эпӗ уна ятран пӗлетӗп, анчах та сӑнлан пӗлместӗп.
Everyone except Tom was wearing a tie.	Томсӑр пуҫне пурте галстук тӑхӑнса ҫӳренӗ.
I heard Tom laughing in the next room.	Том тепӗр пӳлӗмре кулнине илтетӗп.
I sleep with two quilts in the winter.	Хӗлле эпӗ икӗ утиялпа ҫывӑратӑп.
I have something important to tell you.	Санпа калаҫмашкӑн пӗр ҫивӗч калаҫу пур.
Humans were never meant to live forever.	Ҫын ӗмӗрепе пурӑнаймасть.
The novel has sold almost 20,000 copies.	Романӑн 20'000 яхӑн копи сутӑннӑ.
A family is the smallest unit of society.	Ҫемье социумӑн чи пӗчӗк пайӗ.
My uncle is a veteran of the Vietnam War.	Кукка Вйетнам вӑрҫи ветеранӗ.
I never expected Tom to get out of prison.	Эп Том тӗрмерен тухнине пач кӗтменччӗ.
What would you do if you were in my place?	Манӑн вырӑнта пулсассӑн мӗн тӑвӑтӑр ха?
He showed me his collection of butterflies.	Вӑл мана хӑйӗн лӗпӗш пуххи кӑтартрӗ.
I think this sweater will look good on you.	Ман шутпа ку сӑхман санӑн ҫинче чипер курӑнӗ.
The plane took off at exactly nine o'clock.	Вӗҫмек шӑп тӑхӑр сехетре тухса вӗҫсе кайрӗ.
There's a problem there that you don't see.	Эсӗ курман проблем пур.
Tom told me you're the best lawyer in town.	Том каланӑ тӑрӑх эсӗ хулари чи лайӑх саккунҫӑ.
According to the radio, it'll rain tomorrow.	Радиона кура ыран ҫумӑр пулать.
I don't like to sit too close to the screen.	Экрана ҫивӑх ларма юратмастӑп.
They sold out their whole stock of bicycles.	Хӑйсен мӗн пур янтӑ велосипед сутса пӗтерчӗҫ.
She has known him since they were very young.	Вӗсем питӗ ҫамрӑк пулнӑ чух вӑл уна палатччӗ.
Inhaling diesel exhaust is bad for our health.	Дисӗл каяшӗсемпе сывлама сывлӑхшӑн сиенлӗ.
Tom finished doing his homework before dinner.	Том каҫхи апатчченех килти ӗҫӗ туса пӗтерчӗ.
Don't scold her. She's too young to understand.	Ан ятласам уна. Вӑл ытла ҫамрӑк ха ӑнланма.
Kelantan is one of the states in West Malaysia.	Келанттан Анӑҫ Малайси штачӗсенчен пӗрри.
Please tell Tom I'll call again tomorrow morning.	Тархасшӑн эпӗ Тома ыран ирхине тепре шӑнкӑравлатӑп тесе калӑр.
She was happy to be introduced to him at the party.	Паттинче унпа паллашнӑран вӑл питӗ савӑннӑчӗ.
I called a guy I know in the FBI and requested help.	ФБРтан пӗр паллакан ачана шӑнкӑравласа пулӑшу ыйтрӑм.
The next morning, the snowman had completely melted.	Тепӗр кунне юр кӗлетки ирӗлсех кайрӗ.
Excuse me, but could you show me the way to the station?	Каҫарсам, станцие ҫул кӑтартаймастӑр и?
Tom didn't tell you about what happened to Mary, did he?	Том сана Машукпа мӗн пулнӑ пирки каламарӗ вӗт, ҫапла и?
If you leave now, you'll be in Boston by tomorrow evening.	Паян тухсассӑн Бостона ыран ҫитӗн.
The boss told Tom that he had to wear a suit and tie to work.	Босс Тома ӗҫе костӳмпа галстук тӑхӑнма каласа хушрӗ.
You can't sit here if you're not going to play poker with us.	Пирӗнпе покер вылямастӑр пулсан, кунта ан ларӑр.
