Hi.	Živijo.
Hello!	Živijo.
Kiss me.	Poljubi me.
Grab him.	Zgrabi ga.
Hurry up.	Pohiti
I'm lucky.	Imam srečo.
Let's try!	Poskusimo!
I miss you.	Pogrešam te.
Is Tom fun?	Je Tom zabaven?
How are you?	Kako ste?
I was ready.	Bil sem pripravljen.
Is Tom dead?	Je Tom mrtev?
Please stop.	Prosim, nehaj.
Rub my back.	Popraskaj me po hrbtu
Rub my back.	Zmasiraj mi hrbet
Rub my back.	Masiraj mi hrbet.
Are you sure?	Si prepričan?
Is Tom drunk?	Je Tom pijan?
Is Tom dying?	Ali Tom umira?
Sing with me.	Poj z menoj.
I walked home.	Hodil sem domov
Is Tom eating?	Ali Tom je?
Is Tom famous?	Je Tom slaven?
Today was fun.	Danes je bilo zabavno.
We're enemies.	Sovražniki smo.
We're enemies.	Mi smo sovražniki
We're enemies.	Midva sva sovražnika/ Mi smo sovražniki
I often travel.	Pogosto potujem.
I'm free today.	Danes sem prost.
They succeeded.	Uspeli so.
They succeeded.	Uspele so.
This dog bites.	Ta pes grize.
Tom was crying.	Tom je jokal.
Who painted it?	Kdo je to naslikal?
Why do you ask?	Zakaj vprašaš?
I like westerns.	Všeč so mi vesterni.
I smelled bacon.	Vohal sem slanino.
I speak Swedish.	Govorim švedsko.
Is Tom dreaming?	Ali Tom sanja?
Please hurry up!	Prosim, pohiti!
She isn't young.	Ona ni mlada.
You should rest.	Moral bi se spočiti.
He broke his arm.	Zlomil si je roko.
He's in my class.	On je v mojem razredu.
Is Tom delirious?	Se Tomu blede?
My cat is hungry.	Moja mačka je lačna
Tom is an addict.	Tom je odvisnik.
Tom is an addict.	Tom je odvisnež
Tom is an addict.	Tom je odvisnik
Tom was shouting.	Tom je vpil.
You should sleep.	Spati bi moral.
I have no sisters.	Nimam nobenih sester.
I went to the zoo.	Šel sem v živalski vrt.
That won't happen.	To se ne bo zgodilo.
They drank coffee.	Oni so pili kavo.
They drank coffee.	Pili so kavo.
Tom remained calm.	Tom je ostal miren.
Tom was screaming.	Tom je kričal.
Tom was screaming.	Tom se je drl.
I need your advice.	Potrebujem tvoj nasvet.
I want you to stay.	Rad bi ostal.
It was interesting.	Zanimivo je bilo.
Look at this photo.	Poglej tole fotografijo.
Please step inside.	Prosim, vstopite.
Please step inside.	Vstopi, prosim.
That doll is scary.	Ta punčka je strašljiva.
The room was quiet.	V sobi je bila tišina.
When does it close?	Kdaj se zapre?
Where is my office?	Kje je moja pisarna?
Who is my opponent?	Kdo je moj nasprotnik?
I meant to call Tom.	Hotel sem poklicati Tom-a.
Isn't that annoying?	Ali ni nadležno?
Isn't that annoying?	Ali ni zoprno?
Isn't that annoying?	Kaj ni nadležno?
Isn't that annoying?	Kaj ni zoprno?
It's a very hot day.	Zelo vroč dan je.
Let's try something.	Poskusimo nekaj.
Tom listens to Mary.	Tom posluša Mary.
We'll be right over.	Takoj pridemo.
Who wants to see me?	Kdo bi me rad videl?
I wasn't asking that.	To ni bilo moje vprašanje.
I'm washing my hands.	Umivam si roke.
It's a waste of time.	To je izguba časa.
Sumatra is an island.	Sumatra je otok.
The water's very hot.	Voda je zelo vroča.
Tom drank his coffee.	Tom je popil svojo kavo.
Tom slowly retreated.	Tom se je počasi umaknil.
Tom suddenly stopped.	Tom se je nenadoma ustavil.
What was in the oven?	Kaj je bilo v pečici?
Who is already awake?	Kdo je že buden?
Can you speak English?	Znaš angleško?
I don't like your dad.	Tvoj oči mi ni všeč.
I walked about a mile.	Hodil sem kako miljo.
It is Sunday tomorrow.	Jutri je nedelja.
It was you, wasn't it?	Ti si bil, kajne?
Mary let Tom kiss her.	Mary je pustila, da jo Tom poljubi.
Could you walk the dog?	Ali bi lahko psa sprehajal?
Could you walk the dog?	Lahko ti pelješ psa na sprehod?
Could you walk the dog?	Bi lahko ti peljal psa na sprehod?
It doesn't surprise me.	Me ne preseneča.
It's awfully hot today.	Danes je obupno vroče.
It's awfully hot today.	Danes je grozno vroče.
My father will help me.	Moj oče mi bo pomagal.
Tom wants to be famous.	Tom hoče biti slaven.
I want to buy a new car.	Hočem kupiti nov avto.
I'm at a loss for words.	Sem brez besed.
I'm such an unlucky guy.	Jaz sem tako nesrečen fant.
That fish is not edible.	Ta riba je neužitna.
That watch is very nice.	Tista ura je zelo lepa.
The light hurts my eyes.	Svetloba moti moje oči.
You really need a woman.	Resnično potrebuješ žensko.
You should let me do it.	Pusti meni.
He invited me to a party.	Povabil me je na zabavo.
He speaks five languages.	Govori pet jezikov.
I brought you some water.	Prinesel sem ti malo vode.
I got this book from him.	To knjigo sem dobil od njega.
I got this book from him.	To knjigo sem dobila od njega.
No one wants to admit it.	Nihče ne želi priznati.
No one wants to admit it.	Nihče noče priznati.
Raisins are dried grapes.	Rozine so posušeno grozdje.
That wasn't my intention.	To ni bil moj namen.
The girls laughed loudly.	Dekleta so se naglas zasmejala.
Tom was an auto mechanic.	Tom je bil avtomehanik.
What are they doing here?	Kaj delajo tu?
What did you want to say?	Kaj si hotel povedati?
You don't look too happy.	Ne izgledaš preveč srečen.
Can you make the deadline?	Ti bo uspelo do roka?
How much does Tom owe you?	Koliko ti je Tom dolžan?
I asked her out on a date.	Povabil sem jo na zmenek.
I don't have time for you.	Nimam časa zate.
I'm still waiting for you.	Še zmeraj te čakam.
There wasn't much traffic.	Ni bilo veliko prometa.
Tom had a happy childhood.	Tom je imel srečno otroštvo.
Tom is in serious trouble.	Tom je v resnih težavah.
Tom is in serious trouble.	Tom je v resnih težavah
Tom is in serious trouble.	Tom je v hudih težavah.
When will you get married?	Kdaj se boš poročil?
When will you get married?	Kdaj se boš poročila?
When will you get married?	Kdaj se boste poročili?
When will you get married?	Kdaj se boste poročile?
You never say you love me.	Nikoli ne rečeš, da me ljubiš.
He decided to quit smoking.	Odločil se je, da bo nehal kaditi.
He invited me to the party.	Povabil me je na zabavo.
I just want you to shut up.	Vse kar si želim je, da utihneš.
I promise not to judge you.	Obljubim, da te ne bom obsojal.
I returned his book to him.	Vrnil sem mu njegovo knjigo.
The roof needs to be fixed.	Streha mora biti popravljena.
The roof needs to be fixed.	Streha je potrebna popravila.
The roof needs to be fixed.	Streho je treba popraviti.
There's no one in the room.	Nikogar ni v sobi.
Grammar is very complicated.	Slovnica je zelo zapletena.
I caught up with the others.	Dohitel sem ostale.
I figured Tom would be here.	Se mi je zdelo, da bo Tom tukaj.
I'm the one who has the key.	Jaz imam ključ.
People were eager for peace.	Ljudje so bili željni miru.
This won't be the last time.	To ne bo zadnjič.
Tom is an excellent speaker.	Tom je odličen govorec.
We'll all go there together.	Vsi bomo šli tja skupaj.
Why exactly did you do that?	Zakaj točno si storil to?
Why exactly did you do that?	Zakaj točno si to storil?
It is easy to read this book.	Lahko je brati to knjigo.
Portugal is not an exception.	Portugalska ni izjema.
You don't need my permission.	Ne potrebuješ mojega dovoljenja.
Do you think I still love her?	Misliš, da jo še vedno ljubim?
I just don't know what to say.	Ne vem kaj naj rečem.
I've never heard Tom complain.	Nikoli nisem slišal, da bi se Tom pritoževal.
The event affected his future.	Dogodek je vplival na njegovo prihodnost.
They forced me to sing a song.	Prisilili so me, da zapojem pesem.
They forced me to sing a song.	Prisilili so me, da pojem pesem.
Tom works for a small company.	Tom dela za majhno podjetje.
Are you going to come visit me?	Me boš prišel obiskat.
I lived overseas for ten years.	V tujini sem živel 10 let.
I thought you wanted a divorce.	Mislil sem, da hočeš ločitev.
May I tell you a little secret?	Ti lahko povem skrivnost?
Tom doesn't have a credit card.	Tom nima kreditne kartice.
Tom is a very polite young man.	Tom je zelo vljuden mladenič.
Tom is all right at the moment.	Tom je trenutno v redu.
Did you really do that for free?	Si res naredil to zastonj?
He confined himself to his room.	Zaprl se je v svojo sobo.
I didn't kiss him. He kissed me.	Nisem ga poljubil jaz. On je poljubil mene.
I didn't kiss him. He kissed me.	Nisem ga poljubila jaz. On je poljubil mene.
I think it's time for Tom to go.	Mislim, da je čas, da Tom gre.
She went with him to the movies.	Z njim je šla v kino.
The food didn't taste very good.	Hrana ni bila preveč okusna.
Tom doesn't have a bank account.	Tom nima bančnega računa.
Tom left his son a lot of money.	Tom je svojemu sinu zapustil veliko denarja.
About how many books do you have?	Približno koliko knjig imaš?
About how many books do you have?	Približno koliko knjig imata?
About how many books do you have?	Približno koliko knjig imate?
Don't worry. You can count on me.	Ne skrbi. Lahko računaš name.
He has been dead for three years.	Že tri leta je mrtev.
I'm not accusing Tom of anything.	Toma ne obtožujem ničesar.
We'll have to wait a few minutes.	Počakati bomo morali nekaj minut.
We've had some very cold winters.	Imeli smo nekaj zelo mrzlih zim.
When you come back, I'll be gone.	Ko boš prišel nazaj, me ne bo več.
Do you know what's going on there?	Ali veste, kaj se dogaja tam?
I didn't understand your question.	Nisem razumel tvojega vprašanja.
I didn't understand your question.	Nisem razumela tvojega vprašanja.
She works for French intelligence.	Ona dela za francosko obveščevalno službo.
There are ten people in this room.	V tej sobi je deset ljudi.
Tom can't do that as well as Mary.	Tom bo rekel Mary naj počaka.
Tom lives by himself in the woods.	Tom živi sam v gozdu.
Unfortunately, I lost my passport.	Na žalost, sem izgubil moj potni list.
All of a sudden, he proposed to me.	Nenadoma me je zaprosil.
He read the poem with a loud voice.	Prebral je pesem z glasnim glasom.
I was surprised by his resignation.	Bil sem presenečen nad njegovo odpovedjo.
I'm the one who pays all the bills.	Jaz plačujem vse račune.
On whose authority did you do that?	S čigavim dovoljenjem?
She grew up to be a beautiful lady.	Odrasla je v prelepo žensko.
There should be a law against that.	To bi morali prepovedati z zakonom.
We're going to buy ourselves a car.	Mi si bomo kupili avto
You should've kept your mouth shut.	Moral bi držati jezik za zobmi.
Almost everything has been improved.	Skoraj vse je bilo izboljšano.
Do you have anything healthy to eat?	Imate kaj zdravega za pojesti?
I assumed Mary was Tom's girlfriend.	Predvideval sem, da je Mary Tomova punca.
I persuaded him to consult a doctor.	Prepričal sem ga, da se posvetuje z zdravnikom.
I won't ask you anything else today.	Ničesar drugega te ne bom vprašal danes.
If we stay here, we'll probably die.	Če ostanemo tukaj, bomo umrli.
That shouldn't be much of a problem.	To ne bi smel biti tak problem.
The calculator on the table is mine.	Kalkulator na mizi je moj.
Tom handed the picture back to Mary.	Tom je sliko vrnil Mary.
Tom made a few grammatical mistakes.	Tom je naredil nekaj slovničnih napak.
You don't have enough money, do you?	Nimaš dovolj denarja, kajne?
I don't believe I've heard that name.	Mislim da še nikoli nisem slišal tega imena.
I helped my father water the flowers.	Svojemu očetu sem pomagal zaliti rože.
I helped my father water the flowers.	Svojemu očetu sem pomagala zaliti rože.
I wonder if Tom will need to do that.	Me zanima če bo moral Tom narediti to.
Let's go play basketball in the park.	Pojdimo igrati košarko v park.
Let's go play basketball in the park.	Pojdimo v park igrati košarko.
May I tell Tom what you just told me?	Ali lahko Tom-u povem, kar si mi ravnokar rekla?
She felt in her handbag for her ring.	Potipala je po torbici za njenim prstanom.
He has been ill for the past few days.	Zadnjih nekaj dni je bil bolan.
I can't come today or tomorrow either.	Danes ne morem priti, jutri pa tudi ne.
I'm wondering what to cook for dinner.	Sprašujem se, kaj skuhati za večerjo.
My father will support me financially.	Moj oče mi bo pomagal finančno.
Tom wiped the sweat from his forehead.	Tom si je s čela obrisal znoj.
What happened to the rest of the food?	Kaj se je zgodilo z ostalo hrano?
I was reading a letter when he entered.	Ko je prišel sem bral/a pismo.
Tom remembers his first date with Mary.	Tom se spominja prvega zmenka z Mary.
Tom remembers his first date with Mary.	Tom se spomni svojega prvega zmenka z Mary.
Will you still be here when I get back?	Boš še tu ko se vrnem?
Aren't you the one who caused this mess?	A nisi ti tisti, ki je zakuhal tole?
It was right where Tom said it would be.	Bilo je točno tam, kje je Tom rekel da bo.
The accident occurred yesterday morning.	Nesreča se je zgodila včeraj zjutraj.
There is little milk left in the bottle.	V steklenici je ostalo še nekaj mleka.
Tom had to wait in line for three hours.	Tom je moral v vrsti čakati tri ure.
I assumed that Mary was Tom's girlfriend.	Predvideval sem, da je Mary Tomova punca.
I'll call them tomorrow when I come back.	Poklical jih bom jutri, ko se vrnem.
Most people write about their daily life.	Večina ljudi piše o svojem vsakodnevnem življenju.
Tom and Mary don't go to the same school.	Tom in Mary ne hodita na isto šolo.
Tom was surprised that Mary was still up.	Tom je bil presenečen, da je bila Mary še vedno pokonci.
I'll take the phone call in the next room.	Telefonski klic bom sprejel v sosednji sobi.
If I wanted to kill you, I could kill you.	Če bi te želel ubiti, bi te lahko ubil.
If I wanted to kill you, I could kill you.	Če bi te želela ubiti, bi te lahko ubila.
"Can I see your ticket?" "Yes. Here it is."	Lahko vidim vašo vstopnico? Seveda, tukaj je.
Could you tell me how to use the telephone?	Mi lahko poveste, kako se uporablja telefon.
I don't know when my father will come back.	Ne vem, kdaj se bo vrnil moj oče.
I have a daughter the same age as your son.	Imam hčerko iste starosti kot tvoj sin.
I'd like to spend more time with my family.	Rad bi preživel več časa s svojo družino.
I'd like to spend more time with my family.	Rada bi preživela več časa s svojo družino.
Two years have passed since I last met you.	Odkar sem te nazadnje srečal/a sta minili dve leti.
How do I know that you're telling the truth?	Kako naj vem, da govoriš resnico?
Lithuania is a member of the European Union.	Litva je članica Evropske unije.
Ten years have gone by since my father died.	Deset let je minilo, odkar je umrl moj oče.
Tom began to light the candles on the table.	Tom je začel prižigati sveče na mizi.
What are you doing up at this time of night?	Zakaj si pokonci ob tej uri noči?
Could you please take the dog out for a walk?	Ali bi lahko prosim peljal psa na sprehod?
Could you please take the dog out for a walk?	Lahko prosim pelješ psa na sprehod?
Tom has been to your place before, hasn't he?	Tom je že bil pri tebi doma, mar ne?
You must not speak Japanese during the class.	Med poukom ne smeš govoriti japonsko.
How many weeks does it really take to do that?	Koliko tednov v resnici vzame, da narediš to?
Tom asked Mary if she wanted to do that today.	Tom je vprašal Mary, če bi to želela početi danes.
Excuse me, but I'm looking for the post office.	Oprostite, ampak iščem pošto.
If you don't want to answer, you don't have to.	Če nočeš odgovoriti, ti ni treba.
The death of his father filled him with sorrow.	Smrt njegovega očeta ga je napolnila z žalostjo.
The table takes up a lot of space in this room.	Miza v tej sobi zavzame veliko prostora.
Even with his glasses, he doesn't see very well.	Tudi z očali ne vidi dobro.
English is a language spoken throughout the world.	Angleščina je jezik, ki ga govorijo po vsem svetu.
Tom sends more than a hundred text messages a day.	Tom pošlje več kot sto SMS sporočil na dan.
Tom sends more than a hundred text messages a day.	Tom pošlje več kot sto SMS-ov na dan.
I frequently think about my mother who passed away.	Pogosto mislim na svojo pokojno mati.
She waved both her hands so that he could find her.	Pomahala je z obema rokama da bi jo lahko našel.
Tom and Mary entered the classroom at the same time.	Tom in Mary sta hkrati vstopila v učilnico.
Bears often scratch their backs on the bark of trees.	Medvedi si pogosto praskajo svoje hrbte ob lubje dreves.
How did you support yourself before you got this job?	Kako si se preživljal preden si dobil to službo?
After the heavy rains, the river overflowed its banks.	Po močnem deževju je reka poplavila bregove.
My father told me about his experiences during the war.	Moj oče mi je povedal o svojih izkušnjah med vojno.
It was impossible for the boy to swim across that river.	Bilo je nemogoče, da bi fant preplaval to reko.
Tom and Mary have been inseparable for over three years.	Tom in Mary sta neločljiva že več kot tri leta.
Tom and Mary have been inseparable for over three years.	Tom in Mary sta neločljiva več kot tri leta.
He spoke in a broken English that was hard to understand.	Govoril je v polomljeni angleščini, ki jo je bilo težko razumeti.
How did you know Tom was going to go to Boston with Mary?	Kako si vedel, da bo Tom šel v Boston z Mary?
She showed the passengers how to fasten their seat belts.	Potnikom je pokazala, kako si pripeti pas.
I wonder why he didn't eat the apple that fell on his head.	Sprašujem se, zakaj ni pojedel jabolka, ki mu je padlo na glavo.
Many cancer patients lose their hair because of chemotherapy.	Veliko bolnikov, ki zboli za rakom, izgubi svoje lase zaradi kemoterapije.
Mr. Jackson somehow knew that Tom had done my homework for me.	Gospod Jackson je nekako vedel, da je Tom naredil mojo nalogo.
She finally mustered up the courage to ask him for more money.	Končno je zbrala pogum in ga vprašala za več denarja.
Father has lost his job, and what's worse, Mother has fallen ill.	Oče je izgubil službo, in kar je še slabše, mati je zbolela.
I hear my father was as old as I am now when he came up to Tokyo.	Slišim, da je bil moj oče star toliko kot jaz, ko je prišel v Tokio.
